9
10
20
..###.....
..#B#.....
..#.######
###b.s.S##
#S.s@#####
####b#....
...#.#....
...#B#....
...###....
