8
10
35
##########
#@.......#
#..s..b..#
#...BS...#
#...SB...#
#..b..s..#
#........#
##########
